{
  "name": "East Virginia",
  "tile-size": 4.0,
  "tileset": "res/levels/tilesets/big_city_tileset.json",

  "time-limit": 240.0,

  "sublevels": [],

  "ground": {
    "mesh": "res/models/ground/ground_small_city.obj",
    "material": "res/materials/buildings_material.json",

    "scale": 2.0,
    "offset": [-12.0, 0.0],
    "rotation": 90.0
  },

  "layout": [
    "             mbmmbmbmmbbmbmmbmmbb                             ",
    "             s##################m                             ",
    "             m##################m                             ",
    "             s##ppppp###ppppp###Lbmmbmss                      ",
    "             s##ppppp###ppppp##########m                      ",
    "             m##pp1pp###pp1pp##########s                      ",
    "             b##ppppp###ppppp###sssss##s                      ",
    "             b##################pppps##m                      ",
    "             m##################pppps##b                      ",
    "             m##################p3pps##m                      ",
    "             s##pppppppp########pppps##ssmsmm                 ",
    "             m##p      p####################s                 ",
    "             m##p      p####################s                 ",
    "             s##p      p####################b                 ",
    "             s##p      p###sspps###sspppss##m                 ",
    "             m##p      p###sppps###sppppps##s                 ",
    "             s##pppppppp###sppss###sspppss##ssmmsbms           ",
    "             b#####################################m          ",
    "             m#####################################m          ",
    "             m#####################################b          ",
    "             s##sm###ppp###ppTpp###ppp###ppp###sm##m          ",
    "             s##so###p0p###ppppp###pHp###p0p###ss##s          ",
    "             m##sm###ppp###ppppp###ppp###ppp###sb##s          ",
    "             b#################################mm##m          ",
    "             s#################################ss##b          ",
    "             s#####################################m          ",
    "             bsmsL###ssmm##ppppp########sms########m          ",
    "                 s###mbbs##ppPpp########sbm##Bbmb##s          ",
    "                 s###sbbs##ppppp########mbs##bmbb##m          ",
    "                 m###mssm###############ssm########m          ",
    "                 s#################################s          ",
    "                 s#################################s          ",
    "                 bmsmssmbl##pppp#############ppppssb          ",
    "                          m##pp2p###mppppm###p2ppb            ",
    "                          s##pppp###mbppmb###pppps            ",
    "                          s######################s            ",
    "                          m######################m            ",
    "                          m######################s            ",
    "                                ppppppppppppp                 ",
    "                                pp!ppp ppp!pp                 ",
    "                                ppppppppppppp                 "
  ],

  "navigation": [
    "                                                              ",
    "              ##################                              ",
    "              ########x#######x#                              ",
    "              ##     ###     ###                              ",
    "              ##     ###     ##########                       ",
    "              ##     ###     ##########                       ",
    "              ##     ###     ###     ##                       ",
    "              ##################     ##                       ",
    "              ########x#######x#     ##                       ",
    "              ##################     ##                       ",
    "              ##        ########     ##                       ",
    "              ##        ####################                  ",
    "              ##        #x####x##x##########                  ",
    "              ##        ####################                  ",
    "              ##        ###     ###       ##                  ",
    "              ##        ###     ###       ##                  ",
    "              ##        ###     ###       ##                  ",
    "              #####################################           ",
    "              #####x#####x#######x#####x#####x#####           ",
    "              #####################################           ",
    "              ##  ###   ###     ###   ###   ###  ##           ",
    "              ##  ###   ###     ###   ###   ###  ##           ",
    "              ##  ###   ###     ###   ###   ###  ##           ",
    "              #################################  ##           ",
    "              #####x#####x#######x#####x#####x#  ##           ",
    "              #####################################           ",
    "                  ###    ##     ########   ########           ",
    "                  ###    ##     ########   ##    ##           ",
    "                  ###    ##     ########   ##    ##           ",
    "                  ###    ###############   ########           ",
    "                  #x###############################           ",
    "                  ################x########x#######           ",
    "                           ##    ############                 ",
    "                           ##    ###      ###                 ",
    "                           ##    ###      ###                 ",
    "                           ######################             ",
    "                           #######x########x#####             ",
    "                           ######################             ",
    "                                                              ",
    "                                                              ",
    "                                                              "
  ],

  "cross-character": "x",
  "number-of-agents": 20,

  "camera-settings": {
    "position": [16.0, 50.0, -14.0],
    "rotation": [65.0, -45.0, 0.0],

    "size": 120.0,
    "near": 0.1,
    "far": 200.0
  },

  "player-one": {
    "id": 0,
    "car-type": "res/config/cars/monster_truck.json",
    "color": [1.0, 0.0, 0.0],

    "position": [16.0, 36.0],
    "rotation": 135.0
  },

  "player-two": {
    "id": 1,
    "car-type": "res/config/cars/monster_truck.json",
    "color": [0.0, 1.0, 1.0],

    "position": [-16.0, -24.0],
    "rotation": -215.0
  }
}