{
  "name": "big_city_props",
  "tile-size": 4.0,
  "tileset": "res/levels/tilesets/props_tileset.json",

  "ignore" : "#",

  "layout": [
    "                                                              ",
    "              t################t                              ",
    "              #l#####l#l#####l##                              ",
    "              ##     #h#     #h#                              ",
    "              ##     #h#     #########t                       ",
    "              ##     #h#     ##l#####l#                       ",
    "              ##     #h#     #h#     ##                       ",
    "              #l#####l#l#####l##     ##                       ",
    "              ##################     ##                       ",
    "              #l########l#######     ##                       ",
    "              ##p      p########     ##                       ",
    "              ## zzzzzz #############l#####t                  ",
    "              ## zzzzzz ######vv###vv##vvv##                  ",
    "              ## zzzzzz ##l#####l#l#######l#                  ",
    "              ## zzzzzz #h#     #h#       ##                  ",
    "              ## zzzzzz #h#     #h# b T b ##                  ",
    "              ##p      p#h#     #h#       ##                  ",
    "              #l########l#l#####l#l#######l#######t           ",
    "              ##vv###vvv###vvvvv###vvv###v##vvvvv##           ",
    "              #l##l#######l#####l#l###l#######l##l#           ",
    "              ##  #h#   #h#     #h#   #h#   #h#  ##           ",
    "              ##  #h#   #h#     #h#   #h#   #h#  ##           ",
    "              ##  #h#   #h#     #h#   #h#   #h#  ##           ",
    "              #l##l#######lbt#tbl#l###l########  ##           ",
    "              ##vv###vvv###vvvvv#########vv####  ##           ",
    "              t#####l####ll#####l######l###l##l##l#           ",
    "                  #h#    ##     ########   #l####l#           ",
    "                  #h#    ##     ########   ##    ##           ",
    "                  #h#    ##     ########   ##    ##           ",
    "                  #h#    #l#####l#######   #l####l#           ",
    "                  ##l####l###vvv#######l###l#vvvv##           ",
    "                  t#####################vv########t           ",
    "                           ##    ##l######l##                 ",
    "                           ##    #h#    p #h#                 ",
    "                           ##    #h# p    #h#                 ",
    "                           ########l######l#####c             ",
    "                           ##vvvv###vvvvvv######c             ",
    "                           t####################c             ",
    "                                     zzz                      ",
    "                                     zzz                      ",
    "                                     zzz                      "
  ]
}