{
  "name": "Boat City",
  "tile-size": 4.0,
  "tileset": "res/levels/tilesets/city_tileset.json",

  "time-limit": 300.0,

  "sublevels": [],

  "ground-color": [0.463, 0.761, 0.404, 1.0],

  "layout": [
    "                                              ",
    "                                              ",
    "   #########################                  ",
    "   #########################                  ",
    "   #########################                  ",
    "        ###        ###                        ",
    "        ###        ###          ##            ",
    "        ###        ###          ##            ",
    "        ###     ####################          ",
    "        ###     ####################          ",
    "        ###        ###          ##            ",
    "        ###        ###          ##            ",
    "        ##################################    ",
    "        ##################################    ",
    "        ##################################    ",
    "                   ###          ###   ##      ",
    "                   ###          ###   ##      ",
    "                   ###          ###   ##      ",
    "               #########################      ",
    "               #########################      ",
    "               #########################      ",
    "                   ###          ###           ",
    "                   ###          ###           ",
    "                   ###          ###           ",
    "                   ###          ###           ",
    "                   ####################       ",
    "                   ####################       ",
    "                                              ",
    "                                              "
  ],

  "navigation": [
    "                                              ",
    "                                              ",
    "   #########################                  ",
    "   ######x##########x#######                  ",
    "   #########################                  ",
    "        ###        ###                        ",
    "        ###        ###          ##            ",
    "        ###        ###          ##            ",
    "        ###     ####################          ",
    "        ###     ####################          ",
    "        ###        ###          ##            ",
    "        ###        ###          ##            ",
    "        ##################################    ",
    "        #x##########x############x########    ",
    "        ##################################    ",
    "                   ###          ###   ##      ",
    "                   ###          ###   ##      ",
    "                   ###          ###   ##      ",
    "               #########################      ",
    "               #####x############x######      ",
    "               #########################      ",
    "                   ###          ###           ",
    "                   ###          ###           ",
    "                   ###          ###           ",
    "                   ###          ###           ",
    "                   ####################       ",
    "                   ####################       ",
    "                                              ",
    "                                              "
  ],

  "cross-character": "x",
  "number-of-agents": 8,

  "camera-settings": {
    "position": [16.0, 50.0, -14.0],
    "rotation": [65.0, -45.0, 0.0],

    "size": 100.0,
    "near": 0.1,
    "far": 200.0
  },

  "player-one": {
    "id": 0,
    "car-type": "res/config/cars/van.json",
    "color": [1.0, 0.0, 0.0],

    "position": [-16.0, -5.0],
    "rotation": 180.0
  },

  "player-two": {
    "id": 1,
    "car-type": "res/config/cars/van.json",
    "color": [0.0, 1.0, 1.0],

    "position": [4.0, -5.0]
  }
}