{
  "name": "TestMap",
  "tile-size": 4.0,
  "tileset": "res/levels/tilesets/props_tileset.json",

  "ground-color": [0.898, 0.854, 0.890, 1.0],

  "ignore" : "#",

  "layout": [
    "                                ",
    " ###########l#l##bb##l#l####### ",
    " ############################## ",
    " ###########l#l######l#l####### ",
    " ###       zb##      ###    ### ",
    " ###        ###      ###    ### ",
    " ###       zb##      ###    ### ",
    " ###        ###      ###    ### ",
    " ###       zb##      ###    ### ",
    " ###        ###      ###    ### ",
    " ###       zb##      ###    ### ",
    " l#l########l#l######l#l####l#l ",
    " ############################## ",
    " l##########l#l######l#l######l "
  ]
}